######
#....#
#.##.#
#.##.#
#.##.#
#....#
######